111111111           
10000000111111111
1000 000000000001
11111111111111111
R 10 100